#アジア
AKM	= "countries/Asia.txt"	#アクモラ
BRN	= "countries/Asia.txt"	#ブルネイ
COC	= "countries/Asia.txt"	#ココス諸島
BHK	= "countries/Asia.txt"	#ブハラ
INC	= "countries/Asia.txt"	#インドシナ
MUS	= "countries/Asia.txt"	#モーリシャス
SIN	= "countries/Asia.txt"	#シンガポール
SYC	= "countries/Asia.txt"	#セーシェル
TLS	= "countries/Asia.txt"	#東ティモール
WTR	= "countries/Asia.txt"	#西トルキスタン

#中華(アジア)
FNG	= "countries/Asia.txt"	#福建
GNG	= "countries/Asia.txt"	#広東
GZH	= "countries/Asia.txt"	#貴州
HKG	= "countries/Asia.txt"	#香港
KWA	= "countries/Asia.txt"	#関東州
MCA	= "countries/Asia.txt"	#澳門
NAN	= "countries/Asia.txt"	#南京
SCH	= "countries/Asia.txt"	#四川
TWN	= "countries/Asia.txt"	#台湾
ZHI	= "countries/Asia.txt"	#直隷

#インド(アジア)
AZA	= "countries/Asia.txt"	#自由インド
ORI	= "countries/Asia.txt"	#オリッサ

#藩王国(アジア)
BAL	= "countries/Asia.txt"	#バルーチスターン
BNG	= "countries/Asia.txt"	#バンガナパッレ
HYD	= "countries/Asia.txt"	#ハイダラーバード
JAK	= "countries/Asia.txt"	#ジャンムー・カシュミール
MYS	= "countries/Asia.txt"	#マイソール
PUD	= "countries/Asia.txt"	#プドゥコーッタイ
TRV	= "countries/Asia.txt"	#トラヴァンコール
VPS	= "countries/Asia.txt"	#諸藩連邦

#大洋州(アジア)
CHR	= "countries/Asia.txt"	#クリスマス島
COK	= "countries/Asia.txt"	#クック諸島
KIR	= "countries/Asia.txt"	#キリバス
MHL	= "countries/Asia.txt"	#マーシャル諸島
NCL	= "countries/Asia.txt"	#ニューカレドニア
NFK	= "countries/Asia.txt"	#ノーフォーク島
NIU	= "countries/Asia.txt"	#ニウエ
NMR	= "countries/Asia.txt"	#ナウル
PCN	= "countries/Asia.txt"	#ピトケアン
PLW	= "countries/Asia.txt"	#パラオ
TKL	= "countries/Asia.txt"	#トケラウ
TON	= "countries/Asia.txt"	#トンガ
TVL	= "countries/Asia.txt"	#ツバル
VUT= "countries/Asia.txt"	#バヌアツ
WLF	= "countries/Asia.txt"	#ウォリスフツナ

#中東
ABK	= "countries/Middle East.txt"	#アブハジア
BHR = "countries/Middle East.txt"	#バーレーン
CCS	= "countries/Middle East.txt"	#コーカサス
MOU	= "countries/Middle East.txt"	#山岳

#英連邦王国
AGU	= "countries/Commonwealth.txt"	#アンギラ
BMU	= "countries/Commonwealth.txt"	#バミューダ諸島
CYM	= "countries/Commonwealth.txt"	#ケイマン島
GUE	= "countries/Commonwealth.txt"	#ガーンジー
JER	= "countries/Commonwealth.txt"	#ジャージー
FKL	= "countries/Commonwealth.txt"	#フォークランド
GIB	= "countries/Commonwealth.txt"	#ジブラルタル
MNN	= "countries/Commonwealth.txt"	#マン島
MSR	= "countries/Commonwealth.txt"	#モンセトラ
NFL	= "countries/Commonwealth.txt"	#ニューファンドランド
SHN	= "countries/Commonwealth.txt"	#セントヘレナ
TCA	= "countries/Commonwealth.txt"	#タークス・カイコス

#西欧
ADR	= "countries/Western Europe.txt"	#アンドラ
CAL	= "countries/Western Europe.txt"	#カリフォルニア
CLU	= "countries/Western Europe.txt"	#ワシントン・コロンビア
FRO	= "countries/Western Europe.txt"	#フェロー諸島
GRL	= "countries/Western Europe.txt"	#グリーンランド
GLR	= "countries/Western Europe.txt"	#五大湖地域
LIE	= "countries/Western Europe.txt"	#リヒテンシュタイン
MCO	= "countries/Western Europe.txt"	#モナコ
NEL	= "countries/Western Europe.txt"	#ニューイングランド
NMX	= "countries/Western Europe.txt"	#ニューメキシコ
RHI	= "countries/Western Europe.txt"	#ラインラント
SAR	= "countries/Western Europe.txt"	#ザール
SGR	= "countries/Western Europe.txt"	#南ドイツ
SIC	= "countries/Western Europe.txt"	#シチリア
SMR	= "countries/Western Europe.txt"	#サンマリノ
SPM	= "countries/Western Europe.txt"	#サンピエール島及びミクロン島
SRD	= "countries/Western Europe.txt"	#サルディーニャ
TEX	= "countries/Western Europe.txt"	#テキサス
VAL	= "countries/Western Europe.txt"	#ヴァッレ・ダオスタ
VAT	= "countries/Western Europe.txt"	#バチカン
VNC	= "countries/Western Europe.txt"	#アドリア
WAS	= "countries/Western Europe.txt"	#ワシントン

#東欧
ALA	= "countries/Western Europe.txt"	#オーランド諸島
DON	= "countries/Eastern Europe.txt"	#ドン
KAR	= "countries/Eastern Europe.txt"	#カレリア
RUS	= "countries/Eastern Europe.txt"	#ロシア
SIB	= "countries/Eastern Europe.txt"	#シベリア
YNN	= "countries/Eastern Europe.txt"	#ヤマロ・ネネツ

#アフリカ
COM	= "countries/Africa.txt"	#コモロ
CPV	= "countries/Africa.txt"	#カーボベルデ
CYR	= "countries/Africa.txt"	#キレナイカ
EQA	= "countries/Africa.txt"	#赤道アフリカ
FEZ	= "countries/Africa.txt"	#フェザーン
LSO	= "countries/Africa.txt"	#レソト
MYT	= "countries/Africa.txt"	#マヨット
R-U	= "countries/Africa.txt"	#ルアンダ・ウルンディ
REU	= "countries/Africa.txt"	#レユニオン
SML	= "countries/Africa.txt"	#ソマリランド
SSD	= "countries/Africa.txt"	#南スーダン
STP	= "countries/Africa.txt"	#サントメ・プリンシペ
SWL	= "countries/Africa.txt"	#スワジランド
TRP	= "countries/Africa.txt"	#トリポリタニア
WAF	= "countries/Africa.txt"	#西アフリカ
ZAN	= "countries/Africa.txt"	#ザンジバル

#南米
ARB	= "countries/South America.txt"	#アルバ
ATG	= "countries/South America.txt"	#アンティグア・バーブーダ
BRB	= "countries/South America.txt"	#バルバドス
DMA	= "countries/South America.txt"	#ドミニカ
GRD	= "countries/South America.txt"	#グレナダ
MTQ	= "countries/South America.txt"	#マルティニーク
SBL	= "countries/South America.txt"	#サン・バルテルミー
SKN	= "countries/South America.txt"	#セントクリストファー・ネイビス
SLC	= "countries/South America.txt"	#セントルシア
SVG	= "countries/South America.txt"	#セントビンセント及びグレナディーン諸島
