#Asia
ALT	= "countries/Asia.txt"	#アルタイ
BAN	= "countries/Asia.txt"	#バングラデシュ
BHU	= "countries/Asia.txt"	#ブータン
BUK	= "countries/Asia.txt"	#ブハラ
BRM	= "countries/Asia.txt"	#ビルマ
BYA	= "countries/Asia.txt"	#ブリヤート
CAM	= "countries/Asia.txt"	#カンボジア
CHI	= "countries/Asia.txt"	#中華
CKK	= "countries/Asia.txt"	#チュクチ
FEA	= "countries/Asia.txt"	#極東
FIJ	= "countries/Asia.txt"	#フィジー
GUM	= "countries/Asia.txt"	#グアム
GXC	= "countries/Asia.txt"	#広西
HAW	= "countries/Asia.txt"	#ハワイ
IND	= "countries/Asia.txt"	#インド
INS	= "countries/Asia.txt"	#インドネシア
JAP	= "countries/Asia.txt"	#日本
KKP	= "countries/Asia.txt"	#カラカルパクスタン
KAZ	= "countries/Asia.txt"	#カザフスタン
KHI	= "countries/Asia.txt"	#ヒヴァ
KOR	= "countries/Asia.txt"	#韓
KYR	= "countries/Asia.txt"	#キルギスタン
LAO	= "countries/Asia.txt"	#ラオス
MAL	= "countries/Asia.txt"	#マラヤ
MLD	= "countries/Asia.txt"	#モルディブ
MAN	= "countries/Asia.txt"	#満州
MEN	= "countries/Asia.txt"	#蒙疆
FSM	= "countries/Asia.txt"	#ミクロネシア
MON	= "countries/Asia.txt"	#モンゴル
NEP	= "countries/Asia.txt"	#ネパール
PAK	= "countries/Asia.txt"	#パキスタン
PNG	= "countries/Asia.txt"	#パプアニューギニア
PHI	= "countries/Asia.txt"	#フィリピン
SKH	= "countries/Asia.txt"	#サハ
SAM	= "countries/Asia.txt"	#サモア
SHA	= "countries/Asia.txt"	#陝西
SHX	= "countries/Asia.txt"	#山西
SIA	= "countries/Asia.txt"	#シャム
SIK	= "countries/Asia.txt"	#新疆
SOL	= "countries/Asia.txt"	#ソロモン諸島
SRL	= "countries/Asia.txt"	#スリランカ
TAJ	= "countries/Asia.txt"	#タジキスタン
TAH	= "countries/Asia.txt"	#タヒチ
TAY	= "countries/Asia.txt"	#タイミル
TIB	= "countries/Asia.txt"	#チベット
TMS	= "countries/Asia.txt"	#トルクメニスタン
TUV	= "countries/Asia.txt"	#トゥヴァ
UZB	= "countries/Asia.txt"	#ウズベキスタン
VIN	= "countries/Asia.txt"	#ベトナム
VLA	= "countries/Asia.txt"	#ウラジオストク
XIB	= "countries/Asia.txt"	#西北
YAM	= "countries/Asia.txt"	#ヤマリア
YGR	= "countries/Asia.txt"	#ユグラ
YUN	= "countries/Asia.txt"	#雲南

#Middle East
ABK	= "countries/Middle East.txt"	#アブハジア
AFG	= "countries/Middle East.txt"	#アフガニスタン
ARM	= "countries/Middle East.txt"	#アルメニア
AZR	= "countries/Middle East.txt"	#アゼルバイジャン
GEO	= "countries/Middle East.txt"	#グルジア
IRN	= "countries/Middle East.txt"	#イラン
IRQ	= "countries/Middle East.txt"	#イラク
ISR	= "countries/Middle East.txt"	#イスラエル
JOR	= "countries/Middle East.txt"	#ヨルダン
KUR	= "countries/Middle East.txt"	#クルディスタン
KUW	= "countries/Middle East.txt"	#クウェート
LEB	= "countries/Middle East.txt"	#レバノン
OMA	= "countries/Middle East.txt"	#オマーン
PAL	= "countries/Middle East.txt"	#パレスチナ
QAT	= "countries/Middle East.txt"	#カタール
SAU	= "countries/Middle East.txt"	#サウード
SYR	= "countries/Middle East.txt"	#シリア
TRC	= "countries/Middle East.txt"	#トルーシャル・オマーン
TUR	= "countries/Middle East.txt"	#トルコ
YEM	= "countries/Middle East.txt"	#イエメン

#Commonwealth
AST	= "countries/Commonwealth.txt"	#オーストラリア
CAN	= "countries/Commonwealth.txt"	#カナダ
ENG	= "countries/Commonwealth.txt"	#イングランド
IRE	= "countries/Commonwealth.txt"	#アイルランド
NZL	= "countries/Commonwealth.txt"	#ニュージーランド
NIR	= "countries/Commonwealth.txt"	#北アイルランド
SCO	= "countries/Commonwealth.txt"	#スコットランド
WLS	= "countries/Commonwealth.txt"	#ウェールズ

#Western Europe
USA	= "countries/Western Europe.txt"	#アメリカ
ADU	= "countries/Western Europe.txt"	#アンダルシア
AUS	= "countries/Western Europe.txt"	#オーストリア
BAY	= "countries/Western Europe.txt"	#バイエルン
BEL	= "countries/Western Europe.txt"	#ベルギー
BRI	= "countries/Western Europe.txt"	#ブルターニュ
CAT	= "countries/Western Europe.txt"	#カタルーニャ
COR	= "countries/Western Europe.txt"	#コルシカ
CYP	= "countries/Western Europe.txt"	#キプロス
DEN	= "countries/Western Europe.txt"	#デンマーク
DXL	= "countries/Western Europe.txt"	#ディキシーランド
FRA	= "countries/Western Europe.txt"	#フランス
GLC	= "countries/Western Europe.txt"	#ガリシア
GER	= "countries/Western Europe.txt"	#ドイツ
HAN	= "countries/Western Europe.txt"	#ハノーファー
HOL	= "countries/Western Europe.txt"	#ホラント
ICE	= "countries/Western Europe.txt"	#アイスランド
ITA	= "countries/Western Europe.txt"	#イタリア
LUX	= "countries/Western Europe.txt"	#ルクセンブルク
MLT	= "countries/Western Europe.txt"	#マルタ
MEK	= "countries/Western Europe.txt"	#メクレンブルク
NAV	= "countries/Western Europe.txt"	#ナバラ
NOR	= "countries/Western Europe.txt"	#ノルウェー
OCC	= "countries/Western Europe.txt"	#オクシタニア
POR	= "countries/Western Europe.txt"	#ポルトガル
PRE	= "countries/Western Europe.txt"	#プロイセン
SRD	= "countries/Western Europe.txt"	#サルディーニャ
SAX	= "countries/Western Europe.txt"	#ザクセン
SHL	= "countries/Western Europe.txt"	#シュレースヴィヒ
SIC	= "countries/Western Europe.txt"	#シチリア
SPA	= "countries/Western Europe.txt"	#スペイン
SWE	= "countries/Western Europe.txt"	#スウェーデン
SWI	= "countries/Western Europe.txt"	#スイス
TUS	= "countries/Western Europe.txt"	#トスカーナ
VAT	= "countries/Western Europe.txt"	#バチカン
VNC	= "countries/Western Europe.txt"	#ヴェネツィア
WGR	= "countries/Western Europe.txt"	#西ドイツ
WUR	= "countries/Western Europe.txt"	#ヴュルテンベルク

#Eastern Europe
ALB	= "countries/Eastern Europe.txt"	#アルバニア
BSK	= "countries/Eastern Europe.txt"	#バシコルトスタン
BLR	= "countries/Eastern Europe.txt"	#ベラルーシ
BOS	= "countries/Eastern Europe.txt"	#ボスニア
BUL	= "countries/Eastern Europe.txt"	#ブルガリア
CHU	= "countries/Eastern Europe.txt"	#チュヴァシ
CRI	= "countries/Eastern Europe.txt"	#クリミア
CRO	= "countries/Eastern Europe.txt"	#クロアチア
CZE	= "countries/Eastern Europe.txt"	#チェコ
DAG	= "countries/Eastern Europe.txt"	#ダゲスタン
DNZ	= "countries/Eastern Europe.txt"	#ダンツィヒ
DON	= "countries/Eastern Europe.txt"	#ドン
EGR	= "countries/Eastern Europe.txt"	#東ドイツ
EST	= "countries/Eastern Europe.txt"	#エストニア
FIN	= "countries/Eastern Europe.txt"	#フィンランド
GRE	= "countries/Eastern Europe.txt"	#ギリシャ
HRZ	= "countries/Eastern Europe.txt"	#ヘルツェゴビナ
HUN	= "countries/Eastern Europe.txt"	#ハンガリー
KBK	= "countries/Eastern Europe.txt"	#カバルダ＝バルカル
KAL	= "countries/Eastern Europe.txt"	#カルムイク
KAR	= "countries/Eastern Europe.txt"	#カレリア
KSH	= "countries/Eastern Europe.txt"	#カシュビア
KHA	= "countries/Eastern Europe.txt"	#ハカス
KOM	= "countries/Eastern Europe.txt"	#コミ
KOS	= "countries/Eastern Europe.txt"	#コソボ
KUB	= "countries/Eastern Europe.txt"	#クバン
LAT	= "countries/Eastern Europe.txt"	#ラトビア
LIT	= "countries/Eastern Europe.txt"	#リトアニア
MAC	= "countries/Eastern Europe.txt"	#マケドニア
MEL	= "countries/Eastern Europe.txt"	#マリ・エル
MOL	= "countries/Eastern Europe.txt"	#モルダヴィア
MNT	= "countries/Eastern Europe.txt"	#モンテネグロ
NEN	= "countries/Eastern Europe.txt"	#ネネツ
NCC	= "countries/Eastern Europe.txt"	#北コーカサス
NOA	= "countries/Eastern Europe.txt"	#北オセチア
POL	= "countries/Eastern Europe.txt"	#ポーランド
ROM	= "countries/Eastern Europe.txt"	#ルーマニア
SER	= "countries/Eastern Europe.txt"	#セルビア
SIL	= "countries/Eastern Europe.txt"	#シレジア
SLO	= "countries/Eastern Europe.txt"	#スロバキア
SLV	= "countries/Eastern Europe.txt"	#スロベニア
SOV	= "countries/Eastern Europe.txt"	#ソビエト
TAT	= "countries/Eastern Europe.txt"	#タタールスタン
TRA	= "countries/Eastern Europe.txt"	#トランシルヴァニア
UDM	= "countries/Eastern Europe.txt"	#ウドムルト
UKR	= "countries/Eastern Europe.txt"	#ウクライナ
VLG	= "countries/Eastern Europe.txt"	#ヴォルガ
YUG	= "countries/Eastern Europe.txt"	#ユーゴスラビア

#Africa
AFA	= "countries/Africa.txt"	#アファール
ALG	= "countries/Africa.txt"	#アルジェリア
AMH	= "countries/Africa.txt"	#アムハラ
ANG	= "countries/Africa.txt"	#アンゴラ
BEG	= "countries/Africa.txt"	#ベニシャングル＝グムズ
BOT	= "countries/Africa.txt"	#ボツワナ
BRD	= "countries/Africa.txt"	#ブルンジ
CMR	= "countries/Africa.txt"	#カメルーン
CAF	= "countries/Africa.txt"	#中央アフリカ
CHA	= "countries/Africa.txt"	#チャド
COG	= "countries/Africa.txt"	#コンゴ
IVO	= "countries/Africa.txt"	#コートジボワール
DAH	= "countries/Africa.txt"	#ダホメ
DJI	= "countries/Africa.txt"	#ジブチ
EAF	= "countries/Africa.txt"	#東アフリカ
EGY	= "countries/Africa.txt"	#エジプト
EQG	= "countries/Africa.txt"	#赤道ギニア
ERI	= "countries/Africa.txt"	#エリトリア
ETH	= "countries/Africa.txt"	#エチオピア
GAB	= "countries/Africa.txt"	#ガボン
GBA	= "countries/Africa.txt"	#ガンベラ
GHA	= "countries/Africa.txt"	#ガーナ
GNA	= "countries/Africa.txt"	#ギニア
GNB	= "countries/Africa.txt"	#ギニア＝ビサウ
HAR	= "countries/Africa.txt"	#ハラール
KEN	= "countries/Africa.txt"	#ケニア
LIB	= "countries/Africa.txt"	#リベリア
LBA	= "countries/Africa.txt"	#リビア
MAD	= "countries/Africa.txt"	#マダガスカル
MLW	= "countries/Africa.txt"	#マラウイ
MLI	= "countries/Africa.txt"	#マリ
MRT	= "countries/Africa.txt"	#モーリタニア
MCG	= "countries/Africa.txt"	#中部コンゴ
MOR	= "countries/Africa.txt"	#モロッコ
MZB	= "countries/Africa.txt"	#モザンビーク
NMB	= "countries/Africa.txt"	#ナミビア
NGE	= "countries/Africa.txt"	#ニジェール
NGA	= "countries/Africa.txt"	#ナイジェリア
ORO	= "countries/Africa.txt"	#オロミア
RIF	= "countries/Africa.txt"	#リーフ
RWA	= "countries/Africa.txt"	#ルワンダ
SEN	= "countries/Africa.txt"	#セネガル
SID	= "countries/Africa.txt"	#シダマ
SIE	= "countries/Africa.txt"	#シエラレオネ
SOM	= "countries/Africa.txt"	#ソマリア
SAF	= "countries/Africa.txt"	#南アフリカ
SUD	= "countries/Africa.txt"	#スーダン
TZN	= "countries/Africa.txt"	#タンザニア
GAM	= "countries/Africa.txt"	#ガンビア
TIG	= "countries/Africa.txt"	#ティグレ
TOG	= "countries/Africa.txt"	#トーゴ
TUN	= "countries/Africa.txt"	#チュニジア
UGA	= "countries/Africa.txt"	#ウガンダ
VOL	= "countries/Africa.txt"	#オートボルタ
WES	= "countries/Africa.txt"	#西サハラ
ZAM	= "countries/Africa.txt"	#ザンビア
ZIM	= "countries/Africa.txt"	#ジンバブエ

#South America
ARG	= "countries/South America.txt"	#アルゼンチン
BLZ	= "countries/South America.txt"	#ベリーズ
BOL	= "countries/South America.txt"	#ボリビア
BRA	= "countries/South America.txt"	#ブラジル
CAY	= "countries/South America.txt"	#カイエンヌ
CHL	= "countries/South America.txt"	#チリ
COL	= "countries/South America.txt"	#コロンビア
COS	= "countries/South America.txt"	#コスタリカ
CUB	= "countries/South America.txt"	#キューバ
CRC	= "countries/South America.txt"	#キュラソー
DOM	= "countries/South America.txt"	#ドミニカ
ECU	= "countries/South America.txt"	#エクアドル
ELS	= "countries/South America.txt"	#エルサルバドル
GDL	= "countries/South America.txt"	#グアドループ
GUA	= "countries/South America.txt"	#グアテマラ
GYA	= "countries/South America.txt"	#ガイアナ
HAI	= "countries/South America.txt"	#ハイチ
HON	= "countries/South America.txt"	#ホンジュラス
JAM	= "countries/South America.txt"	#ジャマイカ
MEX	= "countries/South America.txt"	#メキシコ
NIC	= "countries/South America.txt"	#ニカラグア
PAN	= "countries/South America.txt"	#パナマ
PAR	= "countries/South America.txt"	#パラグアイ
PRU	= "countries/South America.txt"	#ペルー
PUE	= "countries/South America.txt"	#プエルトリコ
SUR	= "countries/South America.txt"	#スリナム
BAH	= "countries/South America.txt"	#バハマ
TRI	= "countries/South America.txt"	#トリニダード
URG	= "countries/South America.txt"	#ウルグアイ
VEN	= "countries/South America.txt"	#ベネズエラ
WIN	= "countries/South America.txt"	#西インド諸島

